1
###############################
#p     *f *    *   *  * * *   #
# # # #*# # #*#*# # # #*#*#*# #
#   *     *b*  *      *   * * #
# # # # # #*# # #*#*# # # # #*#
#f  b  s  o   *  *  *         #
# # # # # # # # # #*#1#*# # # #
#*  *      b  *      *        #
# # # # #*# # # #*#*# # # # # #
#f    **  *       *           #
# #*# # # # # # #*# # # # # # #
#           *   *  *          #
###############################

Meta data:
(Number or Level) (Rows) (Columns)

Info Tiles:
# - Wall
* - Brick

Mobs:
p - Player

Powerups:
b - Powerup Bombs
f - Powerup Flames
s - Powerup Speed
o - Malus decrease speed
